##############
SP.###.......#
#..#......#..#
#......####.##
#.###....##.##
#...#...###.##
#######...#.##
#####....#####
#.....###....#
####...#.....#
#......###.###
#............#
#...#..####..#
#...##..###.GE
##############
IIIIIIIIIIIIII